1 1 1 1 1 1 1 1 1 1 1 1 1 1 1 1 1 1 1 1 1 1 1 1 1
1 4 4 4 0 0 0 4 0 5 0 3 3 3 3 3 0 0 0 4 0 0 0 4 1
1 4 0 0 0 3 3 3 0 0 0 3 0 2 2 3 0 5 4 0 0 3 3 3 1
1 0 0 0 3 2 2 2 3 0 5 3 2 2 2 3 5 0 0 0 0 3 2 2 1
1 0 3 3 2 2 2 2 2 3 0 3 3 3 3 3 0 0 0 4 0 3 3 3 1
1 0 3 2 2 2 2 2 2 3 0 0 0 0 0 0 4 0 0 0 5 0 0 0 1
1 0 3 2 2 2 2 2 2 3 0 0 0 4 0 0 0 0 0 5 0 3 3 3 1
1 0 3 3 2 2 2 2 3 0 0 5 0 0 0 0 0 4 0 0 3 2 2 2 1
1 0 0 3 3 3 3 3 0 5 0 0 0 0 0 0 5 0 0 3 2 2 2 2 1
1 0 0 0 0 0 0 0 0 4 0 0 0 0 0 0 0 0 3 2 2 2 2 2 1
1 0 0 0 0 4 0 0 0 0 0 0 4 0 0 0 0 0 3 3 3 3 3 3 1
1 0 0 0 0 0 0 0 5 0 0 0 0 0 0 0 0 3 0 0 0 0 0 0 1
1 4 0 0 0 0 0 0 0 0 0 0 0 0 4 0 3 0 0 0 0 0 0 0 1
1 4 0 0 5 0 0 0 0 0 0 0 0 0 0 3 0 0 0 0 0 0 4 0 1
1 0 0 0 4 0 0 5 0 0 0 0 0 4 3 0 0 0 0 0 0 0 0 0 1
1 0 0 0 0 0 0 0 0 0 0 0 3 0 0 0 5 0 0 0 4 0 0 0 1
1 0 0 0 0 0 0 4 0 0 0 0 0 0 0 0 0 0 0 5 0 0 0 0 1
1 0 0 0 0 5 0 0 0 0 0 0 0 0 0 5 0 0 0 0 0 0 0 0 1
1 0 0 0 0 0 0 0 0 0 5 0 0 0 0 0 0 0 0 0 0 0 0 0 1
1 0 0 0 0 0 0 0 0 0 0 0 0 0 0 0 0 0 0 0 0 0 0 0 1
1 0 0 0 0 0 0 0 5 0 0 0 0 0 0 0 0 0 0 0 0 0 0 0 1
1 0 0 0 0 0 0 0 0 0 0 0 0 0 0 0 0 0 0 0 0 0 0 0 1
1 4 4 0 0 0 0 0 0 0 0 0 0 0 0 0 0 0 0 0 0 0 4 4 1
1 4 0 0 0 0 0 0 0 0 0 0 0 0 0 0 0 0 0 0 0 0 0 4 1
1 1 1 1 1 1 1 1 1 1 1 1 1 1 1 1 1 1 1 1 1 1 1 1 1
